135
8
22 4 0 0 0 0 0 0 0 0 0 0 0 0 3 22 22 22 22 22 22 22 22 22 22 22 22 4 0 0 0 0 0 0 0 0 0 0 0 0 0 0 0 0 0 0 0 0 3 22 22 22 22 22 22 22 22 22 22 22 22 22 22 22 22 22 22 22 22 22 22 22 22 22 22 22 22 22 22 22 22 22 22 22 22 22 22 22 22 4 0 0 0 0 0 0 0 0 0 0 0 0 0 0 0 0 0 0 0 0 0 3 22 22 22 22 22 22 22 22 22 22 22 22 22 22 22 22 22 22 22 22 22 22 22 
22 4 0 0 0 0 0 0 0 0 0 0 0 0 3 22 22 22 22 22 22 22 22 22 22 22 22 4 0 0 0 0 0 0 0 0 0 0 0 0 0 0 0 0 0 0 0 0 3 22 22 22 22 22 22 22 22 22 22 22 22 22 22 22 22 22 22 22 22 22 22 22 22 22 22 22 22 22 22 22 22 22 19 17 17 17 17 17 17 0 0 0 0 0 0 0 0 0 0 0 0 0 0 0 0 0 0 0 0 0 0 3 22 22 22 22 22 22 19 17 17 17 17 17 17 17 17 17 17 17 17 17 17 18 22 
22 4 0 0 0 0 0 0 0 0 0 0 0 0 3 22 22 22 22 22 22 22 22 22 22 22 22 4 0 0 0 0 0 0 0 0 0 0 0 0 0 0 0 0 0 0 0 0 3 22 22 19 17 18 22 19 17 18 22 22 22 22 22 22 22 22 22 22 19 17 17 17 17 17 17 17 17 17 17 17 17 17 0 0 0 0 0 0 0 0 0 1 21 2 1 21 2 0 0 0 0 0 0 0 0 0 0 0 0 0 0 3 22 22 22 22 22 22 4 0 0 0 0 0 0 0 0 0 0 0 0 0 0 3 22 
22 4 0 0 0 0 0 0 0 0 0 0 0 0 0 18 22 22 22 22 22 22 22 22 22 22 19 0 0 0 0 0 0 0 0 0 0 0 0 0 0 0 0 0 0 0 0 0 3 22 19 0 0 3 22 4 0 0 18 22 22 22 22 22 16 22 22 22 4 0 0 0 0 0 0 0 0 0 0 0 0 0 0 0 0 0 0 0 0 0 0 23 24 24 24 24 25 0 0 0 0 0 0 0 0 0 0 0 0 0 0 3 22 22 22 22 22 22 4 0 0 0 0 0 0 0 0 23 24 24 25 0 0 3 22 
22 4 0 0 0 1 21 2 0 0 0 0 0 0 0 0 17 18 22 22 22 22 22 22 19 17 0 0 0 0 0 0 0 0 0 0 0 0 0 1 21 2 0 1 21 2 0 0 0 17 0 0 0 3 22 4 0 0 0 17 17 18 22 19 0 18 22 19 0 0 0 0 0 0 0 0 0 0 0 0 0 0 0 0 0 0 0 0 0 0 0 0 0 0 0 0 0 0 0 0 0 1 21 2 0 0 0 0 0 0 0 0 17 18 22 22 22 19 0 0 0 0 0 0 0 0 0 0 0 0 0 0 0 3 22 
22 4 0 0 0 3 22 4 0 0 0 0 0 0 0 0 0 0 17 17 17 17 17 17 0 0 0 0 0 0 0 0 23 24 25 0 0 0 1 21 21 21 21 21 21 2 0 0 0 0 0 0 0 3 22 4 0 0 0 0 0 0 17 0 0 0 17 0 0 0 0 0 0 0 0 0 0 0 0 0 0 0 0 0 0 23 24 25 0 0 0 0 0 0 0 0 0 0 0 0 0 3 22 4 0 0 0 0 23 24 25 0 0 0 17 17 17 0 0 0 0 0 23 24 25 0 0 0 0 0 0 0 0 3 22 
22 4 1 21 2 3 22 4 1 21 2 0 0 0 0 1 21 2 0 0 0 0 0 0 1 21 2 0 0 0 0 0 0 0 0 0 0 0 3 22 19 17 17 18 22 4 0 0 0 0 1 21 2 0 17 0 1 21 2 20 0 0 1 21 8 21 2 0 0 1 21 2 0 1 21 2 0 1 21 8 21 21 2 0 0 0 0 0 0 0 0 0 0 0 0 0 0 0 1 21 2 3 22 4 0 0 0 0 0 0 0 1 21 2 0 0 1 21 2 0 0 0 0 0 0 0 0 0 0 0 0 0 0 3 22 
5 21 21 21 21 8 21 2 1 21 2 0 0 0 1 21 21 21 21 21 21 21 21 21 21 21 21 21 21 21 2 0 0 0 0 0 0 0 3 22 4 0 0 3 22 4 0 0 1 21 21 21 21 21 21 21 21 21 21 21 2 1 21 7 21 7 21 2 1 21 21 21 21 21 21 21 21 21 21 21 21 21 21 2 0 0 0 0 0 0 0 0 23 24 25 0 0 0 3 22 4 3 22 4 1 21 2 0 0 0 0 1 21 21 21 21 21 21 2 0 0 0 0 0 0 0 0 0 0 0 0 0 0 3 22 
