20
8
0 0 0 0 30 32 30 0 0 0 0 0 0 0 0 0 0 0 0 0 
0 0 0 0 0 31 0 0 0 0 0 0 0 0 0 0 0 0 0 0 
0 0 0 0 0 42 0 0 0 0 0 0 0 0 0 0 0 0 0 0 
0 0 0 0 0 0 0 0 0 0 0 0 0 0 0 0 0 0 0 0 
3 0 0 0 0 0 0 0 0 0 0 0 0 0 0 0 0 0 0 0 
3 0 0 0 0 0 0 0 0 0 0 0 0 0 0 0 0 0 0 0 
31 30 30 0 0 41 0 3 40 33 4 0 0 0 0 0 0 0 0 0 
30 30 31 0 0 32 32 0 0 35 0 0 0 0 0 0 0 0 0 0 
